550;600
11;9
00000000000
02111111110
01010101010
01010101010
01010101010
01010101010
01010101010
01111101110
00000000000
38;38
52;100
48;48
5
2
9;7
3;5
1;25
2;3;5
