750;700
15;11
000000000000000
011111111111110
010100000001010
010111111111010
010101010101010
010101111101010
010101010101010
010111111111010
010100000001010
011111111111110
000000000000000
38;38
53;100
48;48
3
4
9;7
3;5
1;7
14;3
4;20
3;5;1
11;10;9
19;13;5
26;1;6